################
#   ## ### #####
## ###      #  #
#              #
#      @       #
#              #
#      #       #
#      #       #
#   ## ### #####
#              #
#              #
#              #
################
