############################################
#     ##    ###       #####       ##       #
# ## ######     ####     ###  ######   ##  #
# #        ##      #        #       #      #
# #   #### ##  ##  ######   ###  #  #  ### #
# #   #        ##      @       ##   #      #
# #   #   ##         ######         ###### #
# ### ### ######   ##      ##   ########## #
#     #       #    #  ##    #       #      #
### #######   ###### ## #######    ##  ##  #
#        #     #              ##          ##
#   ######     #  ######  ##   #####  ###  #
#         ######       ##   ##     ##      #
############################################